┌─────┬───┐
│     │   │
│ ╶─┐ └─┐ │
│   │   │ │
├─╴ │ ╶─┘ │
│   │    ●│
└───┴─────┘
