┌─────┬─┬───┐
│     │ │   │
│ ╶─┐ │ ╵ ╷ │
│   │ │   │ │
├─╴ └─┴───┘ │
│          ●│
└───────────┘
